Ad Astra - космический мод, добавляющий новые планеты и измерения. 
AI-Improvements - оптимизация искусственного интеллекта мобов. 
Akashic Tome - удобный инструмент для хранения книг и руководств. 
alexsmobs - добавляет множество новых мобов в игру. 
Allthemodium - мод на новые ресурсы и материалы. 
Alltheores - добавляет в игру новые виды руд. 
Almostnuffed - вносит изменения в фермерство и пищу. 
Another Furniture - большой выбор мебели и декораций. 
Apotheosis - мод, расширяющий возможности зачарований и анвилов. 
Appleskin - отображение информации о питании еды. 
Applied Energistics 2 - система хранения и автоматизации. 
Architectury - API и библиотека, необходимые для некоторых модов.
Archaelogy - библиотека.
Artifacts - уникальные артефакты и аксессуары для игрока. 
Assembly Line Machines - добавляет механизмы и автоматизацию.
AttributeFix - Исправляет атрибуты предметов и мобов. 
AutoRegLib - Библиотека, требуемая для работы некоторых модов. 
balm - API и библиотека для модов на Fabric и Forge. 
betteradvancements - Улучшает интерфейс достижений. 
BetterF3 - Добавляет больше информации на экран отладки F3. 
betterfpsdist - Оптимизирует отображение дистанции. 
betterstats - Улучшенная статистика игрока. 
biggerreactors - Мод на большие многоблочные реакторы. 
BoatBreakFix - Предотвращает ломание лодок о лилии. 
Bookshelf - Библиотека, требуемая для работы других модов. 
botarium - Автоматизация фермерства с помощью ботанических террариумов. 
canary - Библиотека, предоставляющая дополнительные возможности для разработчиков модов. 
cherishedworlds - Улучшает управление сохраненными мирами.
chipped - Модификация для расширения декоративных блоков. 
citadel - Библиотека, необходимая для работы других модов. 
clickadv - Улучшает интерфейс достижений. 
cloth-config - API для конфигурации модов. 
Clumps - Группирует опыт в один шар, чтобы уменьшить нагрузку на сервер. 
CodeChickenLib - Библиотека, используемая во многих модах. 
configured - Добавляет в игру удобное меню конфигураций для модов. 
Controlling - Улучшает управление клавишами в игре. 
CorgiLib - Библиотека, требуемая для работы модов от мейнтейнера. 
CosmeticArmorReworked - Позволяет носить декоративную броню. 
CraftTweaker - Инструмент для изменения рецептов и игровых механик. 
creeperoverhaul - Модифицирует криперов, добавляя новые виды. 
CTM - Расширяет возможности текстур блоков. 
ctov - Мод, добавляющий новые деревни.
Cucumber - Библиотека, необходимая для работы некоторых модов.
CullLessLeaves-Reforged - Оптимизация отображения листвы, уменьшение нагрузки на систему.
Chunk Loader - загрузчик чанков.
cupboard - Мод на шкафы и дополнительные места для хранения.
curios-forge - Система слотов для аксессуаров и украшений.
DimensionStages - Ограничение доступа к измерениям до выполнения определенных условий.
Ding - Проигрывает звук при завершении загрузки мира.
doapi - Библиотека для работы других модов.
ecologics - Добавляет новые биомы и улучшает существующие.
elevatorid - Простой и удобный мод на лифты.
embededium - Улучшает производительность и совместимость модов.
EnchantmentDescriptions-Forge - Отображает описание зачарований при наведении курсора.
endermanoverhaul-forge - Добавляет новые виды эндерменов.
EnderStorage - Мод на межпространственные сундуки для хранения предметов.
entangled - Мод на связывание инвентарей между блоками.
Entity_Collision_FPS_Fix - Исправляет проблемы с производительностью из-за столкновений сущностей.
entityculling - Оптимизация отображения сущностей, скрытых от обзора.
expandability - Добавляет новые возможности и функции.
Fallingleaves - Добавляет падающие листья для более реалистичного мира.
FastLeafDecay - Ускоряет распад листвы после срубки дерева.
fastpaintings - Ускоряет отображение картин.
Fancymenu - мод для создания уникального меню.
ferritecore - Оптимизация использования памяти.
FluxNetworks - Мод на создание сетей для передачи энергии.
FpsReducer2 - Снижает нагрузку на систему для увеличения FPS.
ftb-library - Библиотека, необходимая для работы модов от FTB.
ftb-quests-forge - система квестов от FTB. 
ftb-teams-forge - управление командами и правами игроков в модпаках FTB. 
ftb-xmod-compat-forge - совместимость модов FTB с другими модами. 
functionalstorage - расширенные системы хранения. 
fusion - мод для создания новых сплавов и материалов. 
GameStages-Forge - система этапов игры, позволяющая ограничивать доступ к контенту. 
geckolib-forge - анимационная библиотека для модов. 
gpmemcleanfix - оптимизация использования оперативной памяти. 
handcrafted-forge - добавляет ручное создание уникальных предметов. 
hc - библиотека, необходимая для работы кастомных механик. 
HealthOverlay - изменяет интерфейс здоровья игрока. 
iceandfire - добавляет драконов и мифических существ. 
iChunUtil - библиотека, необходимая для работы модов от iChun.
ImmediatelyFast - оптимизация.
InventorySorter - упорядочивает инвентарь одним кликом. 
ironfurnaces - улучшенные версии печей. 
IronJetpacks - добавляет в игру ранцы для полета. 
item-filters - позволяет создавать фильтры для предметов. 
Jade - показывает информацию о блоках и мобах при наведении курсора. 
jeed - мод на динамические эмоции и анимации. 
jei - показывает рецепты и использует функции в игре. 
JER-Integration - интеграция ресурсов и статистики для модов. 
journeymap - карта мира в реальном времени. 
JustEnoughProfessions - информация о профессиях в игре. 
JustEnoughResources - показывает распределение ресурсов и дроп с мобов. 
kotlinforforge - необходим для работы модов на Kotlin.
Konkrete - библиотека. 
KryptonReforged - оптимизирует сетевой стек игры.
kubejs-forge - мощный инструмент для создания и настройки рецептов и контента. 
L_Enders_Cataclysm - добавляет эпические битвы и события в игре. 
lazydfu - оптимизирует загрузку данных. 
letmedespawn - позволяет игрокам принудительно деспауниться. 
letsdo-bakery - добавляет выпечку и связанные рецепты. 
letsdo-beachparty - добавляет пляжные мероприятия и предметы. 
letsdo-candlelight - добавляет свечи и атмосферное освещение. 
letsdo-meadow - добавляет новые биомы лугов. 
letsdo-viney - добавляет виноградники и связанные с ними элементы. 
lightspeed - улучшает производительность игры. 
lionfishapi - библиотека для работы других модов. 
lootr - улучшает систему лута в сундуках. 
MaxHealthFix-Forge - исправляет проблемы с максимальным здоровьем.
Mekanism - мод на механизмы и энергию. 
MekanismGenerators - генераторы энергии для Mekanism. 
MekanismTools - инструменты и броня для Mekanism. 
Meldoy - библиотека.
modernity-forge - современные технологии и мебель. 
moonlight - изменяет освещение и тени в зависимости от фазы луны. 
MouseTweaks - улучшает управление инвентарем. 
naturalist-forge - новые растения и деревья. 
NaturesCompass - компас для поиска биомов. 
Necronomicon-Forge - магические ритуалы и знания. 
NekosEnchantedBooks - улучшенные зачарованные книги. 
netherportalfix-forge - исправляет ошибки с порталами в Незер. 
octolib - библиотека для модов. 
oculus-mc1.9.2 - виртуальная реальность в Minecraft. 
Oh_The_Biomes_You'll_Go - новые биомы и исследования.
orestages - управление доступностью ресурсов и предметов по стадиям. 
OverflowingBars - улучшает интерфейс индикаторов игрока. 
Patchouli - добавляет систему внутриигровых руководств и книг. 
phosphophyllite - библиотека для работы сложных модов. 
pipez - мод на трубы для передачи предметов, жидкостей и энергии. 
Placebo - библиотека, используемая другими модами. 
pneumaticcraft-repressurized - добавляет пневматические механизмы и системы. 
polymorph-forge - позволяет выбирать продукты крафта из нескольких возможных. 
Powah - мод на генерацию и хранение энергии. 
productivebees - расширяет пчеловодство. 
PuzzlesLib - библиотека, требуемая для работы других модов. 
Quark - добавляет разнообразие в ванильный Minecraft.
quartz - Мод на добычу и использование кварца. 
questadditions - Дополнения для системы квестов. 
rechiseled - Добавляет новые блоки и предметы. 
relics - Мод на древние артефакты и реликвии. 
reliquary - Коллекция магических предметов. 
resourcefulconfig - Инструмент для конфигурации модов. 
resourcefullib - Библиотека для работы других модов. 
rhino - Интерпретатор JavaScript для Minecraft. 
right-click-harvest - Сбор урожая правым кликом. 
rubidium-extra - Дополнительные оптимизации для Rubidium. 
sacred_logistics - самописный мод на новые ресурсы и механики. 
saturn - Улучшение производительности игры. 
simplemagnets - Магниты для автоматического сбора предметов. 
sophisticatedbackpacks - Улучшенные рюкзаки с дополнительными функциями.
sophisticatedcore - основная библиотека для модов Sophisticated. 
sophisticatedstorage - улучшенные системы хранения. 
starlight - улучшает производительность освещения. 
Structory - добавляет новые структуры в мир. 
Structory_Towers - добавляет башни и другие высокие структуры. 
supermartijn642configlib - библиотека конфигураций для модов. 
supermartijn642corelib - основная библиотека для модов. 
supplementaries - добавляет новые декоративные и функциональные блоки. 
TerraBlender - инструмент для создания и редактирования террейна. 
Tips - показывает подсказки и советы в игре. 
titanium - библиотека для работы модов. 
ToastControl - управляет отображением уведомлений и тостов. 
tombstone - мод на кладбища и взаимодействие с мертвыми.
Towns-and-Towers - добавляет новые города и башни. 
TravelersTitles - система титулов для игроков. 
visuality - мод на визуальные эффекты. 
VisualWorkbench - улучшает интерфейс верстака. 
WitherSkeletonTweaks - тонкая настройка скелетов-иссушителей. 
yetusexperiments - экспериментальные элементы игры. 
YungsApi - API для модов Yung's. 
YungsBetterDesertTemples - улучшенные пустынные храмы. 
YungsBetterDungeons - более сложные и интересные подземелья. 
YungsBetterEndIsland - улучшенные острова Края. 
YungsBetterJungleTemples - улучшенные храмы в джунглях. 
YungsBetterMineshafts - улучшенные шахты. 
YungsBetterNetherFortresses - улучшенные крепости Нижнего мира. 
YungsBetterOceanMonuments - улучшенные океанические монументы.
YungsBetterStrongholds - улучшенные крепости. 
YungsBetterWitchHuts - улучшенные ведьмины хижины. 
YungsBridges - добавляет мосты. 
YungsExtras - дополнительные улучшения и элементы.